#################################
# K            #       K#      R#
#              # R      D       #
#              #    K   #       #
#           K  #        #       #
#S             D        #       #
#################################