#################################
#         K    #       R#       #
#              #        D       #
#              #        #       #
#              #        #       #
#S             D     K  #   R   #
#################################