#################################
# K            #       K#      R#
#              # R      D       #
#              #        #       #
#              #        #       #
#S             D        #       #
#################################